16
16
4

################
################
################
################
################
################
################
################
################
################
################
################
################
################
################
################

### ############
#      #       #
# #### #       #
# ## # ####### #
# #  #         #
# ## # #### ####
#      #### ####
########### ####
########### ####
########### ####
########### ####
########### ####
########### ####
#####       ####
################
################

################
################
##    ##########
##    ##########
##    ##########
##    ##########
################
################
#####    #######
##### ##########
##### ##########
##### ##########
##### ##########
##### ##########
################
################

################
#      #########
#      #########
#      #########
#      #       #
#      # ##    #
#      # ##    #
######## ##    #
#    ### ##    #
#    ### ##### #
#    ### ##### #
#    ######### #
#    ######### #
# ############ #
#              #
################

